***********
E *   *   *
* * * * * *
*   *   *s*
***********
