*****
*   *
* * *
* * *
* ***
* *s*
* * E
* * *
* * *
* * *
* * *
*   *
*****
