***********
E   *   * *
* * * * * *
*s* * * * *
*** * * * *
*   * * * *
* *** * * *
*     *   *
***********
