*********************************************************
*   *   *   *   *   *   *   *   *   *   *   *   *   *   *
* * * * * * * * * * * * * * * * * * * * * * * * * * * * *
* * * * * * * * * * * * * * * * * * * * * * * * * * * * E
* * * * * * * * * * * * * * * * * * * * * * * * * * * * *
* * * * * * * * * * * * * * * * * * * * * * * * * * * * *
* * * * * * * * * * * * * * * * * * * * * * * * * * * * *
* * * * * * * * * * * * * * * * * * * * * * * * * * * * *
* * * * * * * * * * * * * * * * * * * * * * * * * * * * *
* * * * * * * * * * * * * * * * * * * * * * * * * * * * *
* * * * * * * * * * * * * * * * * * * * * * * * * * * * *
* * * * * * * * * * * * * * * * * * * * * * * * * * * * *
* * * * * * * * * * * * * * * * * * * * * * * * * * * * *
* * * * * * * * * * * * * * * * * * * * * * * * * * * * *
* * * * * * * * * * * * * * * * * * * * * * * * * * * * *
* * * * * * * * * * * * * * * * * * * * * * * * * * * * *
* * * * * * * * * * * * * * * * * * * * * * * * * * * * *
* *   *   *   *   *   *   *   *   *   * * * * * * * * * *
* ************************************* * * * * * * * * *
*                                    s* * * * * * * * * *
*************************************** * * * * * * * * *
*                                       * * * * * * * * *
* *************************************** * * * * * * * *
* *   *   *   *   *   *   *   *   *   *   * * * * * * * *
* * * * * * * * * * * * * * * * * * * * *** * * * * * * *
* * * * * * * * * * * * * * * * * * * * *   * * * * * * *
* * * * * * * * * * * * * * * * * * * * * *** * * * * * *
* * * * * * * * * * * * * * * * * * * * * *   * * * * * *
* * * * * * * * * * * * * * * * * * * * * * *** * * * * *
* * * * * * * * * * * * * * * * * * * * * * *   * * * * *
* * * * * * * * * * * * * * * * * * * * * * * *** * * * *
* * * * * * * * * * * * * * * * * * * * * * * *   * * * *
* * * * * * * * * * * * * * * * * * * * * * * * *** * * *
* * * * * * * * * * * * * * * * * * * * * * * * *   * * *
* * * * * * * * * * * * * * * * * * * * * * * * * *** * *
* * * * * * * * * * * * * * * * * * * * * * * * * *   * *
* * * * * * * * * * * * * * * * * * * * * * * * * * *** *
* * * * * * * * * * * * * * * * * * * * * * * * * * *   *
* * * * * * * * * * * * * * * * * * * * * * * * * * * ***
* * * * * * * * * * * * * * * * * * * * * * * * * * * * *
* * * * * * * * * * * * * * * * * * * * * * * * * * * * *
* * * * * * * * * * * * * * * * * * * * * * * * * * * * *
* * * * * * * * * * * * * * * * * * * * * * * * * * * * *
* * * * * * * * * * * * * * * * * * * * * * * * * * * * *
* * * * * * * * * * * * * * * * * * * * * * * * * * * * *
* * * * * * * * * * * * * * * * * * * * * * * * * * * * *
* * * * * * * * * * * * * * * * * * * * * * * * * * * * *
* * * * * * * * * * * * * * * * * * * * * * * * * * * * *
* * * * * * * * * * * * * * * * * * * * * * * * * * * * *
* * * * * * * * * * * * * * * * * * * * * * * * * * * * *
* * * * * * * * * * * * * * * * * * * * * * * * * * * * *
*   *   *   *   *   *   *   *   *   *   *   *   *   *   *
*********************************************************
