*******
E     *
*** * *
*s* * *
* * * *
* * * *
* * * *
* * * *
* * * *
*   * *
*******
