***************
*   *   *   * E
* * * * * * * *
* * * * * * * *
* * * * * * * *
* * * * * * * *
* * * * * * * *
* * * * * * * *
* * * * * * * *
* * * * * * * *
* * * * * * * *
*s* * * * * * *
*** * * * * * *
*   * * * * * *
* *** * * * * *
* *   * * * * *
* * *** * * * *
* * *   * * * *
* * * *** * * *
* * * *   * * *
* * * * *** * *
*   *   *     *
***************
