*****
E   *
* ***
* *s*
* * *
* * *
* * *
* * *
* * *
* * *
* * *
* * *
* * *
*   *
*****
