*********************
*         *   *   * *
* ******* * * * * * *
* *   * * * * * * * *
* * * * * * * * * * *
* * * * *s* * * * * *
* * * * *** * * * * *
* * * *   * * * * * *
* * * * * * * * * * *
* * * * * * * * * * *
* * * * * * * * * * *
*   *   *   *   *   *
*****E***************
