*****************************************************
*   *   *   *   *   *   *   *   *   *   *   *   *   *
* * * * * * * * * * * * * * * * * * * * * * * * * * *
* * * * * * * * * * * * * * * * * * * * * * * * * * *
* * * * * * * * * * * * * * * * * * * * * * * * * * *
* * * * * * * * * * * * * * * * * * * * * * * * * * *
* * * * * * * * * * * * * * * * * * * * * * * * * * *
* * * * * * * * * * * * * * * * * * * * * * * * * * *
* * * * * * * * * * * * * * * * * * * * * * * * * * E
* * * * * * * * * * * * * * * * * * * * * * * * * * *
* * * * * * * * * * * * * * * * * * * * * * * * * * *
* * * * * * * * * * * * * * * * * * * * * * * * * * *
* * * * * * * * * * * * * * * * * * * * * * * * * * *
* * * * * * * * * * * * * * * * * * * * * * * * * * *
* * * * * * * * * * * * * * * * * * * * * * * * * * *
* * * * * * * * * * * * * * * * * * * * * * * * * * *
* * * * * * * * * * * * * * * * * * * * * * * * * * *
* * * * * * * * * * * * * * * * * * * * * * * * * * *
* * * * * * * * * * * * * * * * * * * * * * * * * * *
* *   *   *   *   *   *   *   *   *   * * * * * * * *
* ************************************* * * * * * * *
*                                    s* * * * * * * *
*************************************** * * * * * * *
*                                       * * * * * * *
* *************************************** * * * * * *
* *   *   *   *   *   *   *   *   *   *   * * * * * *
* * * * * * * * * * * * * * * * * * * * *** * * * * *
* * * * * * * * * * * * * * * * * * * * *   * * * * *
* * * * * * * * * * * * * * * * * * * * * *** * * * *
* * * * * * * * * * * * * * * * * * * * * *   * * * *
* * * * * * * * * * * * * * * * * * * * * * *** * * *
* * * * * * * * * * * * * * * * * * * * * * *   * * *
* * * * * * * * * * * * * * * * * * * * * * * *** * *
*   *   *   *   *   *   *   *   *   *   *   *     * *
*****************************************************
