*********E*****************************
*   *   *   *   *   *   *   *   *   * *
* * * * * * * * * * * * * * * * * * * *
* * * * * * * * * * * * * * * * * * * *
* * * * * * * * * * * * * * * * * * * *
* * * * * * * * * * * * * * * * * * * *
* * * * * * * * * * * * * * * * * * * *
* * * * * * * * * * * * * * * * * * * *
* * * * * * * * * * * * * * * * * * * *
* * * * * * * * * * * * * * * * * * * *
* * * * * * * * * * * * * * * * * * * *
* * * * * * * * * * * * * * * * * * * *
* * * * * * * * * * * * * * * * * * * *
* * * * * * * * * * * * * * * * * * * *
* * * * * * * * * * * * * * * * * * * *
* * * * * * * * * * * * * * * * * * * *
* * * * * * * * * * * * * * * * * * * *
* * * * * * * * * * * * * * * * * * * *
* * * * * * * * * * * * * * * * * * * *
* * * * * * * * * * * * * * * * * * * *
* * * * * * * * * * * * * * * * * * * *
* *   *   *   * * * * * * * * * * * * *
* ************* * * * * * * * * * * * *
*            s* * * * * * * * * * * * *
*************** * * * * * * * * * * * *
*               * * * * * * * * * * * *
* *************** * * * * * * * * * * *
* *   *   *   *   * * * * * * * * * * *
* * * * * * * * *** * * * * * * * * * *
* * * * * * * * *   * * * * * * * * * *
* * * * * * * * * *** * * * * * * * * *
* * * * * * * * * *   * * * * * * * * *
* * * * * * * * * * *** * * * * * * * *
* * * * * * * * * * *   * * * * * * * *
* * * * * * * * * * * *** * * * * * * *
* * * * * * * * * * * *   * * * * * * *
* * * * * * * * * * * * *** * * * * * *
* * * * * * * * * * * * *   * * * * * *
* * * * * * * * * * * * * *** * * * * *
* * * * * * * * * * * * * *   * * * * *
* * * * * * * * * * * * * * *** * * * *
* * * * * * * * * * * * * * *   * * * *
* * * * * * * * * * * * * * * *** * * *
* * * * * * * * * * * * * * * *   * * *
* * * * * * * * * * * * * * * * *** * *
* * * * * * * * * * * * * * * * *   * *
* * * * * * * * * * * * * * * * * *** *
* * * * * * * * * * * * * * * * * *   *
* * * * * * * * * * * * * * * * * * * *
* * * * * * * * * * * * * * * * * * * *
* * * * * * * * * * * * * * * * * * * *
* * * * * * * * * * * * * * * * * * * *
* * * * * * * * * * * * * * * * * * * *
* * * * * * * * * * * * * * * * * * * *
* * * * * * * * * * * * * * * * * * * *
* * * * * * * * * * * * * * * * * * * *
* * * * * * * * * * * * * * * * * * * *
*   *   *   *   *   *   *   *   *   * *
***************************************
