***********
E   *     *
* * * * * *
* * * * * *
* * * * ***
* * * * *s*
* * * * * *
* * * * * *
* * * * * *
* * * * * *
* * * * * *
* * * * * *
* * * * * *
* *   *   *
***********
