*********************
*         *   *   * *
* ******* * * * * * *
E *   * *s* * * * * *
* * * * *** * * * * *
* * * *   * * * * * *
* * * * * * * * * * *
* * * * * * * * * * *
* * * * * * * * * * *
* * * * * * * * * * *
* * * * * * * * * * *
* * * * * * * * * * *
* * * * * * * * * * *
*   *   *   *   *   *
*********************
