***E*************************
*   *   *   *   *   *   *   *
* * * * * * * * * * * * * * *
* *   *   *   *   * * * * * *
* ***************** * * * * *
*              s*   * * * * *
***************** *** * * * *
*                 *   * * * *
* ***************** *** * * *
* *   *   *   *   * *   * * *
* * * * * * * * * * * *** * *
* * * * * * * * * * * *   * *
* * * * * * * * * * * * *** *
* * * * * * * * * * * * *   *
* * * * * * * * * * * * * ***
* * * * * * * * * * * * * * *
* * * * * * * * * * * * * * *
* * * * * * * * * * * * * * *
* * * * * * * * * * * * * * *
* * * * * * * * * * * * * * *
* * * * * * * * * * * * * * *
* * * * * * * * * * * * * * *
* * * * * * * * * * * * * * *
*   *   *   *   *   *   *   *
*****************************
