*********
*   *   *
* * * * *
* * * * *
* * * * *
*s* * * *
*** * * *
*   * * *
* *** * *
* *   * *
* * *** *
* * *   *
* * * ***
* * * * *
* * * * *
* * * * *
* * * * *
*   *   *
*E*******
