*****
*   *
E * *
* * *
* ***
* *s*
* * *
*   *
*****
